NO textures/wolfenstein/blue_stone.xpm
EA textures/wolfenstein/color_stone.xpm
SO textures/wolfenstein/grey_stone.xpm
WE textures/wolfenstein/purple_stone.xpm

C 35,19,73
F 15,6,40

11111111111111
10101
101N1
10001

11111
11111111111111
10101
10101
11111
