NO textures/wolfenstein/grey_stone.xpm
SO textures/wolfenstein/purple_stone.xpm
WE textures/wolfenstein/red_brick.xpm
EA textures/wolfenstein/wood.xpm

F 220,100,0
C 225,30,0

  1111111
  1001
  101111
  1111001
1111111111
