NO textures/test/north.xpm
SO textures/test/south.xpm
WE textures/test/west.xpm
EA textures/test/east.xpm

F 201,15,89
C 28,2,36

11111
10001
10001
10001
10001
10001
11001
10001
10001
10001
10001
1S001
11111
