NO textures/wolfenstein/blue_stone.xpm
EA textures/wolfenstein/color_stone.xpm
SO textures/wolfenstein/grey_stone.xpm
WE textures/wolfenstein/purple_stone.xpm

C 35,19,73
F 15,6,40

      1
111111N11111
1     1
1
1
1
1
1
1