NO textures/wolfenstein/purple_stone.xpm
EA textures/wolfenstein/purple_stone.xpm
SO textures/wolfenstein/grey_stone.xpm
WE textures/wolfenstein/grey_stone.xpm

F      17,    38,     64
C      17,    38,     64





     1111111111111
1111110001    
1000110001 
1000110S01 
1000000001    1
1000000001   101
1000000001   101
1000000001    1
1111111111    1
               1




