NO textures/simonkraft/respawn_anchor_side0.xpm
EA textures/simonkraft/respawn_anchor_side2.xpm
SO textures/simonkraft/respawn_anchor_side4.xpm
WE textures/simonkraft/respawn_anchor_side3.xpm

C 35,19,73
F 15,6,40


1111111111111
11111100011111
11111000001111
1111000N00111
1110000000011
1100000000001
1000011110001
1100011100011
111000010011
111100000111
1111100001111
1111110001111
1111111111111